aburrirse - to get bored
alegrarse - to get happy
cansarse - to get tired
enojarse - to get angry
irritarse - to get irritated
irritarse - to be irritated
ofenderse - to get offended
ofenderse - to be offended
ponerse - to get
relarjarse - to relax
sentirse - to feel

aburrido - bored
asustado - afraid
cansado - tired
enojado - angry
nervioso - nervous
tenso - tense
contento - happy
enfadado - angry
triste - sad
alegre - happy
avergonzado - ashamed
avergonzado - embarrassed
deprimido - depressed
orgulloso - proud
relajado - relaxed

¿cómo te sientes? - how do you feel?
¿qué te pasa? - what's the matter?

asustar - to frighten
comerse las uñas - to bite one's nails
encerrarse (en su cuarto) - to shut oneself up
gritar - to shout/yell
llorar - to cry
pasarlo mal - to have a bad time
pasarlo muy mal - to have a very bad time
permanecer callado - to keep quiet
ponerse rojo - to blush
preocuparse - to worry
preocuparse - to get worried
quejarse - to complain
reír(se) - to laugh
silbar - to whistle
sonreír - to smile
sonrojarse - to blush
tener dolor de cabeza - to have a headache
tener miedo - to be afraid
tener vergüenza - to be ashamed
tener vergüenza - to be embarrassed

caminar - to walk
cantar - to sing
jugar al basquetbol - to play basketball
jugar al béisbol - to play baseball
jugar al tenis - to play tennis
jugar al boliche - to bowl
levantar pesas - to lift weights
pintar - to paint

contar un chiste - to tell a joke
encantar - to be very pleasing
estar de buen humor - to be in a good mood
estar de mal humor - to be in a bad mood
falter - to be missing
falter - to be lacking
hacer ruido - to make noise
quedar - to be remaining
sacar una buena nota - to get a good grade
sacar una mala nota - to get a bad grade

estados de ánimo - states of mind
reacciones - reactions
para sentirse bien - in order to feel well

faxear - to fax (Venezuela)
clickear - to click (Venezuela)
descremada - "light"
me gusta tu look - I like your look (mexico)
dame chance - give me a chance (mexico)
globalización - has caused much change in the hispanic world
carnicería - butcher
mercado abierto - open market
farmacia - pharmacy
hemos tenido - we've had
supermercado - supermarket
almacén - warehouse
además - besides
cadenas - chains
cambiar - to change
comida rápida - fast food
marca - brand
conseguir - to obtain
comida casera - homemade food
mezclas en polvo - powdered mixes
congelado - frozen
microonda - microwave
preparaban a mano - prepared from scratch
aguas de fruta - fruit drinks

