acampar - to go camping
andar en bicicleta - to ride a bicycle
andar en monopatín - to ride a scooter
andar en patineta - to ride a skateboard
bañanarse - to bathe
bañanarse en un jacuzzzi - to bathe in a jacuzzi
bucear - to scuba
dibujar - to draw
escalar montañas  - to mountain climb
esquiar - to ski
esquiar en el agua - to water ski
esquiar en las montañas - to snow ski
hacer camping - to go camping
hacer yoga - to do yoga
ir al teatro - to go to the theater
jugar - to play
jugar a los naipes - to play cards
jugar golf - to play golf
jugar al voleibol - to play volleyball
meditar - to meditate
navegar en un barco - to sail
patinar - to skate
patinar en línea - to inline skate
pescar - to fish
saltar a la cuarda - to jump rope
tener un picnic - to have a picnic
trabajar en el jardín - to garden
utilizar la aromaterapia - to use aromatherapy
dar un paseo - *TODO*
ir a la iglesia - to go to church
leer - to read
levantar pesas - to lift weights
el bosque - the forest
el desierto - the desert
el lago - the lake
el mar - the sea
las montañas - the mountains
el museo - the museum
el océan - the ocean
el parque - the park
el río - the river
chistoso - funny
cómico - comical, funny
gracioso - funny, amusing
el chiste - the joke
la risa - the laugh
la risa - the laughter
causar risa - to cause laughter
hacer reír - to make laugh
harcerle gracia a uno - to strike someone as funny
reír(se) a carcajadas - to laugh loudly
tener gracia - to be funny
tener gracia - to be charming
