la copa - (wine) glass
los cubiertos - silverware
la cuchara - spoon
el cuchillo - kinfe
el cuenco - (earthenware) bowl
la jarra - pitcher
el mantel - tablecloth
la mesa - table
el pimentero - pepper shaper
el platillo - saucer
el plato - plate
el plato de spoa - soup bowl
el salero - salt shaker
la servilleta - napkin
la taza - cup
el tenedor - fork
el vaso - (water) glass
los uenos modales - good manners
cortar - to cut
derramar - to spill
lavar los platos - to wash the dishes
levantar la mesa - to clear the table
poner la mesa - to set the table
el camarero - waiter
la camarera - waitress
el cliente - customer
el cocinero - chef
el cocinero - the cook
la comida para llevar - food to go
la cuenta - the bill
la cuenta - the check
el mesero - waiter
la mesera - waitress
el plato del día - daily special
el plato principal - main dish
el primer plato - first course
el segundo plato - second course
el tercer plato - third course
la propina - tip
atender (ie) - to wait on (a customer)
dejar una propina - to leave a tip
ordener - to order
pedir (i, i) - to request, order
traer (irreg) - to bring
¿Me podría traer...? - Could you bring me ...?
¿Qué trae...? - What does ... come with ?
es imprescindible - it's essential
es buena idea - it's a good idea
es muy buena idea - it's a very good idea
es necesario - it's necessary
es preciso - it's necessary
hay que - one must
hay que - it's necessary
no se puede... sin... - one can't ... without ...
se tiene que - you have to
se tiene que - one must
la boca - mouth
la bolsita para llevar - doggie bag
el brazo - arm
el codo - elbow
la costumbre - custom, habit
la mano - hand
el servicio a domicilio - home delivery
derecho - right
educado - well-mannered
educado - polite
izquierdo - left
invitar - to treat (pay)
probar (ue) - to try, taste
tener buene educación - to be well-mannered
