subjects: yo, tu, el/ella/usted, nosotros, -, ustedes

hablar (present) - hablo, hablas, habla, hablamos, hablan
hablar (imperfect) - hablaba, hablabas, hablaba, hablámos, hablaban

comer (present) - como, comes, come, comemos, -, comen
comer (imperfect) - comía, comías, comía, comíamos, -, comían
comer (preterite) - comí, comiste, comió, comimos, -, comieron

viver (present) - vivo, vives, vive, vivimos, -, viven
viver (imperfect) - vivía, vivías, vivía, vivíamos, -, vivían
viver (preterite) - viví, viviste, vivió, vivimos, -, vivieron

hacer (present) - hago, haces, hace, hacemos, -, hacen
hacer (imperfect) - hacía, hacías, hacía, hacíamos, -, hacían
hacer (preterite) - hici, hiciste, hizo, hicimos, -, hicieron

ir (present) - voy, vas, va, vamos, -, van
ir (imperfect) - iba, ibas, iba, íbamos, -, iban
ir (preterite) - fui, fuiste, fue, fuimos, -, fueron

estar (present) - estoy, estás, está, estamos, -, están
estar (imperfect) - estaba, estabas, estaba, estábamos, -, estaban
estar (preterite) - estuve, estuviste, estuvo, estuvimos, -, estuvieron

ser (present) - soy, eres, es, somos, -, son
ser (imperfect) - era, eras, era, éramos, -, eran
ser (preterite) - fui, fuiste, fue, fuimos, -, fueron

tener (present) - tengo, tienes, tiene, tenemos, - tienen
tener (imperfect) - tenía, tenías, tenía, teníamos, -, tenían
tener (preterite) - tuve, tuviste, tuvo, tuvimos, -, tuvieron

traer (present) - traigo, traes, trae, traemos, -, traen
traer (imperfect) - traía, traías, traía, traíamos, -, traían
traer (preterite) - traje, trajiste, trajo, trajimos, -, trajeron

vener (present) - vengo, vienes, viene, venimos, -, vienen
vener (imperfect) venía, venías, venía, veníamos, - venían
vener (preterite) - vine, veniste, vino, vinimos, -, vinieron

ver (present) - veo, ves, ve, vemos, -, ven
ver (imperfect) - veía, veías, veía, veíamos, -, veían
ver (preterite) - vi, viste, vio, vimos, -, vieron

poder (present) - puedo, puedes, puede, podemos, -, pueden
poder (imperfect) - podía, podías, podía, podíamos, -, podían
poder (preterite) - pude, pudiste, pudo, pudimos, -, pudieron

poner (present) - pongo, pones, pone, ponemos, -, ponen

