assessment - A
A & alive and well - W
chief complaint - CC
complains of - c/o
diagnosis - Dx
family history - FH
head, eyes, ear, nose, throat - HEENT
H & history and physical - P
history - Hx
history of present illness - HPI
present illness - PI
impression - IMP
L & living and well - W
no acute distress - NAD
no known allergies - NKA
no known drug allergies - NKDA
objective information - O
occupational history - OH
plan/recommendation/disposition - P
physical examination - PE
phsyical examination - Px
pupiles equal, round, and reative to light and accommodation - PERRLA
past history - PH
past medical history - PMH
review of symptoms - ROS
systems review - SR
rule out - R/O
subjective information - S
social history - SH
symptom - Sx
usual childhood diseases - UCHD
within normal limits - WNL

