bathroom privileges - BRP
chest pain - CP
discharge, discontinue - DC
ethyl alcohol - ETOH
left - L
right - R
patient - pt
regular rate and rhythm - RRR
shortness of breath - SOB
threatment - Tr
treatment or traction - Tx
vital signs - VS
temperature - T
pulse - P
respiration - R
blood pressure - BP
height - Ht
weight - Wt
well-developed and well-nourished - WDWN
year old - y/o
number or pound - #
female - ♀
male - ♂
degree or hour - °
increased - ↑
decreased - ↓
none or negative - ø
standing - ⚲
sitting - ⚲_
lying - o—

